5
5
3 2 2 1 4
2 1 0 1 3
1 1 1 3 1
2 1 4 3 1
2 2 3 3 1


